Geraldine Davis	Street Bow Hunter Legends
Patricia Taylor	Miniature Monster Crime Scene Investigation
Cheryl Laban	European Demon House
Annie Shannon	Busy Barracuda
May Miller	Cooperative Cardinal
Charles Johnson	Outstanding Opossum
Scott Lenton	Clumsy Cockroach
Jose Lynch	Regal Dwarf Anarchy
Clifford Hernandez	Ugliest Unicorn
Maria Elliott	Papal Werewolf Destruction
Mary Mitchell	Worrisome Wildebeest
Maybelle Adkins	Double Bungie Rebellion
Edwin Odell	Obnoxious Octopus
Odis Willis	Handsome Herring
Brian Bell	Spunky Walrus in the Magic Kingdom
Alma Sams	Embarrassed Echidna
Alice Murphy	Good Guanaco
Kathleen Jahn	Successful Seahorse
Jackie Wall	Shy Stork
Constance Holloway	Topsy-Turvy Dungeon King
Brian Stewart	Careful Curlew
Gladys Schaefer	Kind Kouprey
Alma Smith	Bloody Bug
Laurie Gindlesperger	Foolish Finch
Tim Abrams	The Great Sushi Baseball
Laci Barrows	Psycho Sunshine Derby
