Christine Earl	Comfortable Cottonmouth
Faye Gray	Unstoppable College Armada
Emma Douglas	Comfortable Cottonmouth
William Jewels	Unstoppable College Armada
Laura Fatica	Comfortable Cottonmouth
Michael Raines	Unstoppable College Armada
Marlin Wernimont	Comfortable Cottonmouth
Debra Hickerson	Unstoppable College Armada
William Zielinski	Comfortable Cottonmouth
Blair Hardin	Unstoppable College Armada
Sandra Brucker	Comfortable Cottonmouth
Bruce Hoefler	Unstoppable College Armada
Thomas Mendoza	Comfortable Cottonmouth
James Brugman	Unstoppable College Armada
Jeanne Stam	Comfortable Cottonmouth
Julie Illich	Unstoppable College Armada
Alexander Sloan	Comfortable Cottonmouth
Alejandro Carmichael	Unstoppable College Armada
Edith Jones	Comfortable Cottonmouth
Joanne Freeman	Unstoppable College Armada
Howard Roque	Comfortable Cottonmouth
Gary Funke	Unstoppable College Armada
Dorothy Ellis	Comfortable Cottonmouth
Robert Winn	Unstoppable College Armada
Patricia Reinhart	Comfortable Cottonmouth
Benjamin Thomas	Unstoppable College Armada
Brandon Hoopes	Comfortable Cottonmouth
Leola Brown	Unstoppable College Armada
